########[]##########
#[b]          ~~~~~#
#             ~~~~~#
#             ~~~~~#
#                  #
#   [$]     [T]    #
                  
                  
#                  #
#                  #
####################