####################
#[b][b]¨¨.....~~~~~#
#......¨¨.....~~~~~#
#.............~~~~~#
#[H]...............#
#[$]............[T]#
_.................._
_.................._
#..................#
#.......[*]........#
####################