#############################
#.&...[H]...&.#¨¨¨¨¨¨¨¨¨¨¨¨¨#
#.............#¨....¨¨¨¨¨¨¨¨#
######..#######....¨¨¨¨¨¨¨¨¨#
#.......[*].......¨¨¨¨¨¨¨¨¨¨#
_..........................._
_..........................._
#...........................#
#¨..........................#
#¨¨¨¨..............¨¨¨¨¨¨¨¨¨#
#¨¨¨¨¨¨........¨¨¨¨¨¨¨¨~~~~~#
#¨¨¨¨¨¨¨¨¨¨¨¨¨¨¨¨¨~~~~~~~~~~#
#[b]¨¨¨¨¨¨¨¨¨¨¨~~~~~~~~~~~~~#
##############~~~~~~~~~~~~~~#