#############################
#[H][b][b][*][$][T].........#
#...........................#
#...........................#
#...........................#
_..........................._
_..........................._
#...........................#
#...........................#
#...........................#
#....................¨¨¨~~~~#
#....................¨¨¨~~~~#
#&...................¨¨¨~~~~#
#############################