#############################
#~..~..~..~..~..~..~..~..[b]#
#~..~..~..~..~..~..~..~.....#
#~..~..~..~..~..~..~..~.....#
#~..~..~..~..~..~..~..~.....#
#~..~..~..~..~..~..~..~.....#
#~..~..~..~..~..~..~..~.....#
#..............¨¨¨¨¨¨¨¨¨....#
#...............¨¨¨¨¨¨¨.....#
#[H]............... ¨¨¨¨....#
#...[H]..............¨¨¨¨...#
#&.....................¨¨¨¨.#
#.......................¨¨¨¨#
#############__##############