#############################
~~~~........................#
~~~~........................#
~~~~~.......................#
~~~~.[*]....................#
~~~........................._
~~~..[*]...................._
~~~~........................#
~~~~.[*]....................#
~~~~~.......................#
~~~.........................#
~~~~........................#
~~~~~.......................#
#############################