#############################
#¨¨¨¨¨¨¨¨¨¨¨¨¨¨¨¨¨¨¨¨¨¨¨¨¨¨¨#
#¨¨¨¨¨¨¨¨¨¨¨¨¨¨¨¨¨¨¨¨¨¨¨¨¨¨¨#
#¨¨¨¨¨¨¨¨¨¨¨¨¨¨¨¨¨¨¨¨¨¨¨¨¨¨¨#
#¨¨¨¨¨¨[*]..........¨¨¨¨¨¨¨¨#
_.¨¨¨¨......................_
_..¨¨¨......................_
#¨¨¨¨¨¨...................¨¨#
#¨¨¨¨¨¨.................¨¨¨¨#
#¨¨¨¨¨¨¨...........[*]¨¨¨¨¨¨#
#¨¨¨¨¨¨¨¨¨¨¨¨¨¨¨¨¨¨¨¨¨¨¨¨¨¨¨#
#¨¨¨¨¨¨¨¨¨¨¨¨¨¨¨¨¨¨¨¨¨¨¨¨¨¨¨#
#¨¨¨¨¨¨¨¨¨¨¨¨¨¨¨¨¨¨¨¨¨¨¨¨¨¨¨#
#############################